FFFF6540
0000AA74
00006FF4
00004884
FFFF64CF
0000BE3E
FFFF573C
00007640
FFFF681B
FFFF9347
FFFF5E8E
FFFF59B6
FFFFF02C
0000FF21
FFFFF20F
FFFFF3C8
FFFF6DDE
0000D1D7
0000A7B7
FFFF4B57
00004510
0000849B
FFFF6131
FFFF693A
FFFF4400
FFFF6CB3
FFFFA3D2
0000EF58
FFFFD6E1
FFFFAF03
00001B38
00006E5B
0000E562
00003C24
00004782
0000EE56
000086A8
00006819
0000BF39
FFFF7B84
FFFF9A4B
FFFF3DFC
0000DADE
FFFFE7E3
00008293
00009F3B
FFFF3BFD
000029F6
FFFF3E28
00000165
0000A735
FFFF8851
FFFFB83D
FFFF2961
FFFFB59D
00007837
0000D56C
0000AECE
FFFFA959
FFFF5A42
00008AD3
FFFF3E7B
FFFFA21E
0000A14B
FFFFD847
FFFF3D36
FFFF2C8C
FFFF9F7B
00006B48
0000FA3D
00000441
000035D5
00007713
00009CFA
0000A372
FFFFAA55
0000C030
000091CF
FFFFD09D
0000F8F3
FFFFDBC2
0000A84F
000088DF
000087EA
0000119D
0000F8CE
FFFFC660
FFFFAF53
FFFF7D5B
0000CCD7
FFFFF284
FFFF26A2
0000868F

# note that this testcase will fail on purpose to check your assertion
0000A5ED
FFFF3F91
FFFFDBDE
